11111111111111111111111111111111
111111111111111.........11=====1
1.....11................11==D==1
1....11....11......11....11====1
1..........11......11..........1
1.........111......111.........1
1.........11........11.........1
1..........1........1..........1
1..........1........1..........1
1....111................111....1
1..............................1
1.........1111....1111.........1
1..............................1
1-------.......................1
1-------1111........1111.......1
1---------111111111111.........1
11--------111111111111.........1
11-------11111111111111........1
11====-----.11....11...........1
11====-----...................11
1=====-----...................11
1=P===-----.................1111
1=====-----...1111........111111
11111111111111111111111111111111
